################
#X @           #
# #o           #
# #          # #
# #          # #
# #          # #
# #          # #
# #          # #
# #          # #
# #          # #
# #          # #
# #          # #
# #          # #
# ############ #
#              #
################
