################
#sso G @VVV #  #
#ooo LLL  GG XX#
#           #  #
#              #
#              #
#              #
#              #
#             G#
#              #
#              #
#              #
#              #
#              #
#              #
################
