################
#    GGGGG@L  X#
#    GGGGGGL   #
#    LLLLLLLL  #
#              #
#              #
#              #
#              #
#              #
#              #
#              #
#              #
#              #
#              #
#              #
################
